10
          + + + + +
          +       +
. . . . . . . .   +
. . . . . @ . .   +
. . I . . . . .   +
. . . . . . . .   +
. . . . . . . .   +
          +       +
          +       +
          + + + + +