10
    + + + + + + + +
    +             +
. . . . . . .     +
. . . . . . .     +
. . . . @ . .     +
. . B . . . .     +
. . . . . . .     +
. . . . . . . + + +
. . . . . . .
. . . . . . .