10
          + + + + +
          +       +
. . . . . . . .   +
. . . . . . . .   +
. . C . . @ . .   +
. . . . . . . .   +
. . . . . . . .   +
          +       +
          +       +
          + + + + +