10
. . . . . . . . A .
. . . . . . . . . .
. . . . . . . . . .
. . . . . . . . . .
. . . . @ . . . . .
. . . . . . . . . .
. . . . . .       .
. . . . . .       .
. . . . . .       .
. . . . . . . . . .