12
          . . . . . . .
          . . . . . . .
  .       . . . . . . .
  .       . . . . . . .
  .       . . . . . . .
. . . . . . . . . . . .
. . @ . . . . . . . . .
. . . . . . . . . . . .
. . . . . . . . . . . .
. . . . . . . . . . . .
. . . . . . . . . . . .
. . A . . . . . . . . .